순위,팀명,G,SBA,SB,CS,SB%,OOB,PKO
1,두산,142,231,183,48,79.2,56,4
2,LG,141,246,168,78,68.3,57,12
3,SSG,140,181,144,37,79.6,30,3
4,KIA,140,167,124,43,74.3,44,4
5,삼성,142,142,113,29,79.6,39,4
6,롯데,139,143,104,39,72.7,50,13
7,NC,137,134,102,32,76.1,44,7
8,한화,140,109,68,41,62.4,44,7
9,키움,139,79,66,13,83.5,32,3
10,KT,142,88,61,27,69.3,37,4
