순위,팀명,G,SBA,SB,CS,SB%,OOB,PKO
1,두산,144,234,184,50,78.6,56,4
2,LG,144,250,171,79,68.4,61,12
3,SSG,143,186,147,39,79.0,32,3
4,KIA,143,168,124,44,73.8,44,4
5,삼성,144,142,113,29,79.6,39,4
6,롯데,143,145,105,40,72.4,53,13
7,NC,142,136,103,33,75.7,46,8
8,키움,143,84,71,13,84.5,33,3
9,한화,144,110,69,41,62.7,44,7
10,KT,144,88,61,27,69.3,37,4
