순위,팀명,G,SBA,SB,CS,SB%,OOB,PKO
1,두산,143,231,183,48,79.2,56,4
2,LG,143,248,170,78,68.5,60,12
3,SSG,142,182,144,38,79.1,31,3
4,KIA,141,168,124,44,73.8,44,4
5,삼성,143,142,113,29,79.6,39,4
6,롯데,141,143,104,39,72.7,51,13
7,NC,139,136,103,33,75.7,45,8
8,한화,141,110,69,41,62.7,44,7
9,키움,141,81,68,13,84.0,33,3
10,KT,142,88,61,27,69.3,37,4
