순위,팀명,G,SBA,SB,CS,SB%,OOB,PKO
1,두산,144,234,184,50,78.6,56,4
2,LG,144,250,171,79,68.4,61,12
3,SSG,144,188,149,39,79.3,32,3
4,KIA,144,169,125,44,74.0,45,4
5,삼성,144,142,113,29,79.6,39,4
6,롯데,144,147,105,42,71.4,54,13
7,NC,144,137,104,33,75.9,47,10
8,키움,144,84,71,13,84.5,33,3
9,한화,144,110,69,41,62.7,44,7
10,KT,144,88,61,27,69.3,37,4
