순위,팀명,G,SBA,SB,CS,SB%,OOB,PKO
1,두산,140,225,179,46,79.6,53,4
2,LG,140,246,168,78,68.3,57,12
3,SSG,138,180,143,37,79.4,30,3
4,KIA,138,165,123,42,74.5,44,4
5,삼성,140,142,113,29,79.6,39,4
6,롯데,137,141,103,38,73.0,48,13
7,NC,136,134,102,32,76.1,44,7
8,키움,138,79,66,13,83.5,32,3
9,한화,138,106,65,41,61.3,44,7
10,KT,141,88,61,27,69.3,37,4
