순위,팀명,G,SBA,SB,CS,SB%,OOB,PKO
1,두산,137,221,176,45,79.6,51,4
2,LG,137,246,168,78,68.3,57,12
3,SSG,136,178,141,37,79.2,30,3
4,KIA,138,165,123,42,74.5,44,4
5,삼성,139,141,113,28,80.1,39,4
6,롯데,136,141,103,38,73.0,47,13
7,NC,136,134,102,32,76.1,44,7
8,키움,137,79,66,13,83.5,32,3
9,한화,137,106,65,41,61.3,44,7
10,KT,139,87,60,27,69.0,35,4
