순위,팀명,G,SBA,SB,CS,SB%,OOB,PKO
1,두산,143,231,183,48,79.2,56,4
2,LG,143,248,170,78,68.5,60,12
3,SSG,142,182,144,38,79.1,31,3
4,KIA,142,168,124,44,73.8,44,4
5,삼성,143,142,113,29,79.6,39,4
6,롯데,142,144,104,40,72.2,53,13
7,NC,140,136,103,33,75.7,46,8
8,키움,142,83,70,13,84.3,33,3
9,한화,142,110,69,41,62.7,44,7
10,KT,143,88,61,27,69.3,37,4
