순위,팀명,G,SBA,SB,CS,SB%,OOB,PKO
1,두산,136,219,174,45,79.5,50,4
2,LG,136,246,168,78,68.3,57,12
3,SSG,135,175,138,37,78.9,30,3
4,KIA,137,164,122,42,74.4,44,4
5,삼성,138,140,112,28,80.0,38,4
6,NC,135,134,102,32,76.1,44,7
7,롯데,135,139,101,38,72.7,45,13
8,한화,136,105,64,41,61.0,44,7
8,키움,136,77,64,13,83.1,31,3
10,KT,138,87,60,27,69.0,35,4
